111111111111
1C00000000P1
100000011101
111100000001
1C0000000001
111100000001
1000000000C1
100000000001
100000000001
10000C000001
1E1000000001
111111111111
