1111111111111111111111111111111111
1E1000000000000C00000C000000000001
1010010100100000101001000000010101
1010010010101010001001000000010101
1P0000000C00C0000000000000000000C1
1000000000000000000000000000000001
1111111111111111110000000000000111
1111111111111111110001111111111111
1111000000000000000000000000000011
11C1000000011111111111111111100111
1000011110011000000000001000000001
1000011110000000000000001000000001
1000011110011000000000001C00000001
1000011111111111100110011111000001
1000011110C00000100100000C01000001
100001CC00000000100100000C01000001
1C0001CC00000000000100C000010C0001
1111111111111111111111111111111111